111111111111111111111111
1     2        3 4     1
1222     222   3    4  1
1        2 22  33      1
1 222 4     2 4  3   4 1
1 3   4  2  2      4   1
1 3   2  22 2   4    4 1
1  3  2                1
1 3       3  33    33  1
1 3   33 3   33    23  1
1    3 3  3            1
1 4 3    3  2        2 1
1     4     22      22 1
1  4    4    22222222  1
1         4            1
111111111111111111111111